About = 关于
AboutQuillDriver = 关于QuillDriver
Add = 添加
AddCulturalNote = 添加文化注释
AddGeneralNote = 添加一般注释
AddGrammaticalNote = 添加语法注释
AddInterpretiveNote = 添加说明
AddLexicalNote = 添加词语注释
AddPronunciationNote = 添加读法注释
AddSociolinguisticNote = 添加口语注释
AddSpeaker = 添加声音
AdjustTimeCode = 调整速度
AffectedModule = 外观：
AllFiles = 所有文件
Allowed = 允许
Annotate = 注释
AppendDivision = 添加分界线
Audio = 声音
AUDIO = 声音
Bottom = 底部
Bug = 程序错误
Cancel = 取消
ChangeSpeaker = 改变声音
CheckIn = 登记
Chinese = 汉文
ChooseOne = 选择一个择项
Close = 关闭
ColorInHex = 十六进制颜色值[c.f. http://www.hypersolutions.org/pages/rgbhex.html]：
Copy = 复制
Current = 当前
CurrentPlayable = 当前可播放的
Cut = 剪切
DecreaseStartTime = 减少开始时间
DecreaseStopTime = 减少停止时间
Delete Division = 删除分界线
DeleteClause = 删除子句
DeleteNote = 删除注释
DeleteSentence = 删除句子
DeleteSpeaker = 删除声音
DeleteTranslation = 删除翻译
DESC = 除去
Disallowed = 不能接受
Display = 显示…
Edit = 编辑
EditSpeakerInfo = 编辑扬声器信息
EmailAddress = 电子邮件地址
English = 英文 (English)
EnglishOnly = 只显示英文
EnterEmail = <输入邮件地址>
EnterMailServer = <输入邮件服务器>
EnterName = <输入姓名>
EnterNewSpeakerInfo = 输入新的扬声器信息
Face = 面
FaceColon = 面：
FeatureRequest = 特殊请求
Feedback = 反馈
FeedbackToDevelopers = 返回给开发者
File = 文件
FileNameColon = 文件名：
Filesoftype = 文件类型：
FindHeading = 搜索
FindNextYesNo = 查找下一个
FindReplaceHeading = 搜索和替换
FindSpeaker = 查找扬声器
FindText = 查找文本
FindTime = 查找时间
FindWhat = 查找什么
FixMedia = 修复媒体
Font = 字体：
FontAndStylePreferences = 字体和格式参数
GotoEnd = 到末尾处
GotoNextLine = 到下一行
GotoPreviousLine = 到前一行
GotoStart  = 到开始处
Help = 帮助
HighlightPosition = 加亮位置：
HighlightRelatedPreferences = 加亮选项参数
Icon = 图标
In = 开始
IncreaseStartTime = 增加开始时间
IncreaseStopTime = 增加结束时间
InfoLong = 信息
InfoShort = 信息
Inquiry = 调查
InsertAfter = 行前插入
InsertBefore = 行后插入
InsertDivisionAfter = 后面插入分界线
InsertDivisionBefore = 前面插入分界线
InsertOneTime = 插入时间
InsertSpeaker = 插入声音
InsertTranslation = 插入翻译
InsertTwoTimes = 插入两个时间值
Interface = 界面
JavaMediaFramework = Java媒体播放器
JumpAhead10Lines = 往前跳10行
JumpBack10Lines = 往后跳10行
Keyboard = 键盘
KeyboardInputMethod = 键盘输入方法
Language = 语言：
MarkStartAndStop = 开始和结束标志
MarkStartTime = 开始时间标志
MarkStopTime = 停止时间标志
MaximizeStop = 最多时间
MediaColon = 媒体：
MediaPlayer = 媒体播放器
Metadata = 元数据
Middle = 中
Mode = 模式
MultipleHighlightPolicy = 多重加亮方式：
Name = 姓名
NameColon = 姓名：
Navigate = 导航
New = 新建
NewClause = 新子句
NewProject = 新项目
NewTranscriptText = 建立新的文本
NewWizard = 新界面
Next = 下一个
NextPlayable = 下一个可播放的
NextSentence = 下一句
NoMedia = 没有媒体
NonTibetanFontAndSize = 非藏文的字体及其大小
NoReplace = 不能替换
NOTE = 注释
NotesOnly = 仅备注
NoTranscript = 没有文本
Ok = 确定
Open = 打开
OpenExisting = 打开已有文本
OpenMediaFile = 打开媒体文件
OpenMediaURL = 打开媒体网址
OpenTranscript = 打开文本
Out = 停止
OutgoingMailServer = 邮件服务器提供者
Password = 口令
Paste = 粘贴
Pause = 暂停
Play = 播放
PlayBack = 回放
PlayCurrentLine = 播放当前的
PlayEndofCurrent = 播放至当前末尾
PlayEndofCurrentLine = 从当前行播放到末尾
PlayNext  = 播放下一个
PlayNextLine = 播放下一行
PlayPause = 播放/暂停
PlayPrevious = 播放前一个
PlayPreviousLine = 播放前一行
PlaySegment = 播放一段
PlayVinusValue = 播放时间值（按毫秒）
Preferences = 参数选择
Previous = 前一个
PreviousPlayable = 前一个可播放的
PreviousSentence = 前一句
Priority = 优先权：
Project = 项目
ProjectDetails = 项目详细资料
QDFileFormat = QD文件格式(
QuechuaAndEnglish = 盖丘亚语和英文
QuechuaOnly = 只显示盖丘亚语
QuicktimeforJava = 用于Java的Quicktime播放器
QuillDriverTIBETAN = QuillDriver-藏语
Quit = 结束
RapidDecreaseStart = 快速减少开始时
RapidDecreaseStop = 快速减少停止时间
RapidDncreaseDecreaseValue = 加快/减慢（按毫秒）
RapidIncreaseStart = 快速增加开始时
RapidIncreaseStop = 快速增加结束时
ReadOnly = 只读
Remove = 删除
Replace = 替换
ReplaceAll = 全部替换
ReplaceQ = 替换吗？
ReplaceText = 替换文本
ReplaceWith = 一起替换
Save = 保存
SaveAs = 保存到
SaveCurrent = 保存当前文本
SaveTranscript = 保存注释到
SaveTranscriptAs = 保存文本到
Search = 搜寻
SeekEnd = 寻找末尾
SeekNext = 往后寻找
SeekPrevious = 往前寻找
SeekStart = 寻找开始
SelectAll = 全部搜寻
SelectConfiguration = 选择配置
SelectDataSource = 选择数据源
SelectMedia = 选择媒体
SelectMode = 选择模式：
SelectVideoPlayer = 选择视频播放器
ShowEverything = 显示所有
SlowIncreaseDecreaseValue = 微调增减值
Speakers = 扬声器
StartFromBeginning = 你已经到达文本末尾，是否继续从头查找？
SupportedMediaError = 请参考THDL文档并安装媒体播放器。
SuppressTimes = 隐藏时间
SureDeleteSpeaker = 你确实要删除这个声音吗？
SurroundwithPageLineBreaks = 包围超出页面界线
TextFound = 文本查找。
THDLReadonly = 只读THDL
THDLTranscription = 文本THDL
Tibetan = 藏文
TibetanAndEnglish = 藏文和英文
TibetanFontSize = 藏文字体大小
TibetanOnly = 只显示藏文
TimeCode = 时间参数
TimeCoding = 时间参数…
TimeCodingPreferences = 时间参数选择
TitleColon = 标题：
TranscribeQuechua = Quechua文本
TranscriberName = 文本名
TranscriberTask = 文本任务
Transcript = 文本
TranscriptColon = 文本：
TranscriptionAndNotes = 文本和注释
TranscriptionOnly = 只有文本
TranslationOnly = 只有翻译
TypeMediaURL = 输入你要打开的媒体网址：
TypeMessageHere = 在此输入信息
TypeNewTitleColon = 输入新的标题：
TypeofFeedback = 反馈类型：
UcuchiLive = Ucuchi直播
Video = 视频
View = 视图
WantSave = 你要保存这个文本吗？
Warning = 警告！
WhatToDo = 你要做什么？
WylieAndEnglish = 拉丁转写和英文
ZapTimeCodes = 激活时间码
ChangesToInterface = Changes to the interface will show up\nthe next time you open QuillDriver.
High = High
Medium = Medium
Low = Low
